0000000000000000000000000000000
0000000000000000000000000000000
0000000000000000000000000000000
0000000000000000000000000000000
0000000000000000000011110000000
0000000000000000000000000000000
0000000000000000000000000000000
0000000000111110000000000000000
0000000000000000000000000000000
0000000000000000000000000000000
1111111111111111111111111111111
0000000000000000000000000000000
0000000000000000000000000000000
